%%%%%%%%%%%%%%%%%%%%
%.           ..%   %
%.%%.%%.%%.%%.%% % %
%        P       % %
% %%%% %% % %% %%% %
%..%..             %
%%%%%%%%%%%%%%%%%%%%
