%%%%%%%
%    P%
% %%% %
%  %  %
%%   %%
%. % .%
%%%%%%%
